> Getting Started
< This is just the beginning
# A comment
& newbie
@ dUpDaL
eUeUeUeUeUeUeUeUeUeUeUeU
eUeUeUeUeUeUeUeUeUeUeUeU
eUeUeUeUeUeUeUeUeUeUeUeU
eUeUeUeUeUeUeUeUeUeUeUeU
eUeUeUeUeUeUeUeUeUeUeUeU
eUeUeUeUlReUeUeUeUeUeUeU
eUeUeUeUeUeUeUeUeUeUeUeU
eUeUeUsUxUeUeUeUeUeUeUeU
eUeUeUeUeUeUeUeUeUeUeUeU
eUeUeUeUeUeUeUeUeUeUeUeU
eUeUeUeUeUeUeUeUeUeUeUeU
eUeUeUeUeUeUeUeUeUeUeUeU
!
> Round 2
< A second chance
& dos
@ aRdUpLaDpRdL

eUeUeUeUeUeUeUeUeUeUeUeU
eUeUeUeUeUeUeUeUeUeUeUeU
eUeUeUeUeUeUeUeUeUeUeUeU
eUeUeUeUeUeUeUeUeUeUeUeU
eUeUeUeUeUeUeUeUeUeUeUeU
eUeUbUeUlReUeUeUeUeUeUeU
eUeUeUeUeUeUeUeUeUeUeUeU
eUeUeUsUxUeUeUeUeUeUeUeU
eUeUeUeUeUeUeUeUeUeUeUeU
eUeUeUeUeUeUeUeUeUeUeUeU
eUeUeUeUeUeUeUeUeUeUeUeU
eUeUeUeUeUeUeUeUeUeUeUeU
!

> Level 3
< Making amends
& tres
@ dRpUaDxUdL
eUeUeUeUeUeUeUeUeUeUeUeU
eUeUeUeUeUeUeUeUeUeUeUeU
eUeUeUeUeUeUeUeUeUeUeUeU
eUeUeUeUeUeUeUeUeUeUeUeU
eUeUeUeUeUeUeUeUeUeUeUeU
eUeUeUeUeUeUeUeUeUeUeUeU
eUeUeUsUeUeUeUeUeUeUeUeU
eUeUeUeUeUeUeUeUeUeUeUeU
eUeUeUeUeUeUsUeUeUeUeUeU
eUeUeUeUeUeUeUeUeUeUeUeU
eUeUeUeUeUeUeUeUeUeUeUeU
lLeUeUeUeUeUeUeUeUeUeUeU

!
