> Getting Started
< This is just the beginning
# A comment
& newbie
@ dUpDaL
eUeUeUeUeUeUeUeUeUeUeUeU
eUeUeUeUeUeUeUeUeUeUeUeU
eUeUeUeUeUeUeUeUeUeUeUeU
eUeUeUeUeUeUeUeUeUeUeUeU
eUeUeUeUeUeUeUeUeUeUeUeU
eUeUeUeUlReUeUeUeUeUeUeU
eUeUeUeUeUeUeUeUeUeUeUeU
eUeUeUsUxUeUeUeUeUeUeUeU
eUeUeUeUeUeUeUeUeUeUeUeU
eUeUeUeUeUeUeUeUeUeUeUeU
eUeUeUeUeUeUeUeUeUeUeUeU
eUeUeUeUeUeUeUeUeUeUeUeU
!
> Round 2
< A second chance
& dos
@ aRdUpLaDpRdL

eUeUeUeUeUeUeUeUeUeUeUeU
eUeUeUeUeUeUeUeUeUeUeUeU
eUeUeUeUeUeUeUeUeUeUeUeU
eUeUeUeUeUeUeUeUeUeUeUeU
eUeUeUeUeUeUeUeUeUeUeUeU
eUeUbUeUlReUeUeUeUeUeUeU
eUeUeUeUeUeUeUeUeUeUeUeU
eUeUeUsUxUeUeUeUeUeUeUeU
eUeUeUeUeUeUeUeUeUeUeUeU
eUeUeUeUeUeUeUeUeUeUeUeU
eUeUeUeUeUeUeUeUeUeUeUeU
eUeUeUeUeUeUeUeUeUeUeUeU
!

> a
< b
& c
@ pDxUaU
eUeUeUeUeUeUeUeUeUlDeUeU
eUeUeUeUeUeUeUeUeUeUeUeU
eUeUeUeUeUeUeUeUeUeUeUeU
eUeUeUeUeUeUeUeUeUeUeUeU
eUeUeUeUeUeUeUeUsUeUeUeU
eUeUeUeUeUeUeUeUeUeUeUeU
eUeUeUeUeUeUeUeUeUsUeUeU
eUeUeUeUeUeUeUeUeUeUeUeU
eUeUeUeUeUeUeUeUeUeUeUeU
eUeUeUeUeUeUeUeUeUeUeUeU
eUeUeUeUeUeUeUeUeUeUeUeU
eUeUeUeUeUeUeUeUeUeUeUeU

!
