> Getting Started
< This is just the beginning
# A comment
& newbie
@ dUpDaL
eUeUeUeUeUeUeUeUeUeUeUeU
eUeUeUeUeUeUeUeUeUeUeUeU
eUeUeUeUeUeUeUeUeUeUeUeU
eUeUeUeUeUeUeUeUeUeUeUeU
eUeUeUeUeUeUeUeUeUeUeUeU
eUeUeUeUlReUeUeUeUeUeUeU
eUeUeUeUeUeUeUeUeUeUeUeU
eUeUeUsUxUeUeUeUeUeUeUeU
eUeUeUeUeUeUeUeUeUeUeUeU
eUeUeUeUeUeUeUeUeUeUeUeU
eUeUeUeUeUeUeUeUeUeUeUeU
eUeUeUeUeUeUeUeUeUeUeUeU
!
> Round 2
< A second chance
& dos
@ aRdUpLaDpRdL

eUeUeUeUeUeUeUeUeUeUeUeU
eUeUeUeUeUeUeUeUeUeUeUeU
eUeUeUeUeUeUeUeUeUeUeUeU
eUeUeUeUeUeUeUeUeUeUeUeU
eUeUeUeUeUeUeUeUeUeUeUeU
eUeUbUeUlDeUeUeUeUeUeUeU
eUeUeUeUeUeUeUeUeUeUeUeU
eUeUeUsUxUeUeUeUeUeUeUeU
eUeUeUeUeUeUeUeUeUeUeUeU
eUeUeUeUeUeUeUeUeUeUeUeU
eUeUeUeUeUeUeUeUeUeUeUeU
eUeUeUeUeUeUeUeUeUeUeUeU
!
