
> Getting Started
< Really Dumb
& toddler
@ 
eUeUeUeUeUeUeUeUeUeUeUeU
eUeUeUeUeUeUeUeUeUeUeUeU
eUeUeUeUeUeUeUeUeUeUeUeU
eUlReUeUeUeUeUeUeUsUeUeU
eUeUeUeUeUeUeUeUeUeUeUeU
eUeUeUeUeUeUeUeUeUeUeUeU
eUeUeUeUeUeUeUeUeUeUeUeU
eUeUeUeUeUeUeUeUeUeUeUeU
eUeUeUeUeUeUeUeUeUeUeUeU
eUeUeUeUeUeUeUeUeUeUeUeU
eUeUeUeUeUeUeUeUeUeUeUeU
eUeUeUeUeUeUeUeUeUeUeUeU

!

> Introducing the Deflector
< 90 degrees
& mirror
@ dU
eUeUeUeUeUeUeUeUeUeUeUeU
eUeUeUeUeUeUeUeUeUeUeUeU
eUeUeUlDeUeUeUeUeUeUeUeU
eUeUeUeUeUeUeUeUeUeUeUeU
eUeUeUeUeUeUeUeUeUeUeUeU
eUeUeUeUeUeUeUeUeUeUeUeU
eUeUeUeUeUeUsUeUeUeUeUeU
eUeUeUeUeUeUeUeUeUeUeUeU
eUeUeUeUeUeUeUeUeUeUeUeU
eUeUeUeUeUeUeUeUeUeUeUeU
eUeUeUeUeUeUeUeUeUeUeUeU
eUeUeUeUeUeUeUeUeUeUeUeU

!

> Prisom Song
< Triangles
& prism
@ pDpL
eUeUeUeUeUeUeUeUeUeUeUeU
eUeUeUeUeUeUeUeUeUeUeUeU
eUeUeUeUeUeUeUeUeUeUeUeU
eUeUeUlReUeUeUeUeUeUeUeU
eUeUeUeUeUeUeUeUeUeUeUeU
eUeUeUeUeUeUeUeUeUeUeUeU
eUeUeUsUeUeUeUeUeUeUeUeU
eUeUeUeUeUeUeUeUeUeUeUeU
eUeUeUeUeUeUeUeUeUeUeUeU
eUeUeUeUeUeUeUeUeUeUeUeU
eUeUeUeUeUeUeUeUeUeUeUeU
eUeUeUeUeUeUeUeUeUeUeUeU

!

> Around the bend
< Use 'em all
& wall
@ dRdLpU
eUeUeUeUeUeUeUeUeUeUeUeU
eUeUeUeUeUeUeUeUeUeUeUeU
eUeUeUeUeUeUeUeUeUeUeUeU
eUeUeUlDeUeUeUeUeUeUeUeU
eUeUeUeUeUeUeUeUeUeUeUeU
eUeUeUeUeUeUeUeUeUeUeUeU
eUeUeUwUeUeUeUeUeUeUeUeU
eUeUeUsUeUeUeUeUeUeUeUeU
eUeUeUeUeUeUeUeUeUeUeUeU
eUeUeUeUeUeUeUeUeUeUeUeU
eUeUeUeUeUeUeUeUeUeUeUeU
eUeUeUeUeUeUeUeUeUeUeUeU

!

> Guide
< one way only
& arrow
@ aRaU
eUeUeUeUeUeUeUeUeUeUeUeU
eUeUeUeUeUeUeUeUeUeUeUeU
eUeUeUeUeUeUeUeUeUeUeUeU
eUeUeUeUeUeUeUeUeUeUeUeU
eUeUeUeUeUwUsUeUeUeUeUeU
eUeUeUeUeUeUeUeUeUeUeUeU
eUeUeUeUeUeUeUeUeUeUeUeU
eUeUeUlUeUeUeUeUeUeUeUeU
eUeUeUeUeUeUeUeUeUeUeUeU
eUeUeUeUeUeUeUeUeUeUeUeU
eUeUeUeUeUeUeUeUeUeUeUeU
eUeUeUeUeUeUeUeUeUeUeUeU

!

> Cyclotron
< needs bouncing
& bicycle
@ cL
eUeUeUeUeUeUeUeUeUeUeUeU
eUeUeUeUeUeUeUeUeUeUeUeU
eUeUeUeUeUeUeUeUeUeUeUeU
eUeUeUeUwUeUeUeUeUeUeUeU
eUeUeUeUeUeUeUeUeUeUeUeU
eUeUwUeUeUeUsUeUeUeUeUeU
eUeUeUeUeUeUeUeUeUeUeUeU
eUeUeUeUeUeUeUeUeUeUeUeU
eUeUeUeUlUeUeUeUeUeUeUeU
eUeUeUeUeUeUeUeUeUeUeUeU
eUeUeUeUeUeUeUeUeUeUeUeU
eUeUeUeUeUeUeUeUeUeUeUeU

!
