
> Getting Started
< Really Dumb
& toddler
@ 
eUeUeUeUeUeUeUeUeUeUeUeU
eUeUeUeUeUeUeUeUeUeUeUeU
eUeUeUeUeUeUeUeUeUeUeUeU
eUlReUeUeUeUeUeUeUsUeUeU
eUeUeUeUeUeUeUeUeUeUeUeU
eUeUeUeUeUeUeUeUeUeUeUeU
eUeUeUeUeUeUeUeUeUeUeUeU
eUeUeUeUeUeUeUeUeUeUeUeU
eUeUeUeUeUeUeUeUeUeUeUeU
eUeUeUeUeUeUeUeUeUeUeUeU
eUeUeUeUeUeUeUeUeUeUeUeU
eUeUeUeUeUeUeUeUeUeUeUeU

!

> Introducing the Deflector
< 90 degrees
& mirror
@ dU
eUeUeUeUeUeUeUeUeUeUeUeU
eUeUeUeUeUeUeUeUeUeUeUeU
eUeUeUlDeUeUeUeUeUeUeUeU
eUeUeUeUeUeUeUeUeUeUeUeU
eUeUeUeUeUeUeUeUeUeUeUeU
eUeUeUeUeUeUeUeUeUeUeUeU
eUeUeUeUeUeUsUeUeUeUeUeU
eUeUeUeUeUeUeUeUeUeUeUeU
eUeUeUeUeUeUeUeUeUeUeUeU
eUeUeUeUeUeUeUeUeUeUeUeU
eUeUeUeUeUeUeUeUeUeUeUeU
eUeUeUeUeUeUeUeUeUeUeUeU

!

> Prisom Song
< Triangles
& prism
@ pDpL
eUeUeUeUeUeUeUeUeUeUeUeU
eUeUeUeUeUeUeUeUeUeUeUeU
eUeUeUeUeUeUeUeUeUeUeUeU
eUeUeUlReUeUeUeUeUeUeUeU
eUeUeUeUeUeUeUeUeUeUeUeU
eUeUeUeUeUeUeUeUeUeUeUeU
eUeUeUsUeUeUeUeUeUeUeUeU
eUeUeUeUeUeUeUeUeUeUeUeU
eUeUeUeUeUeUeUeUeUeUeUeU
eUeUeUeUeUeUeUeUeUeUeUeU
eUeUeUeUeUeUeUeUeUeUeUeU
eUeUeUeUeUeUeUeUeUeUeUeU

!

> Around the bend
< Use 'em all
& wall
@ dRdLpU
eUeUeUeUeUeUeUeUeUeUeUeU
eUeUeUeUeUeUeUeUeUeUeUeU
eUeUeUeUeUeUeUeUeUeUeUeU
eUeUeUlDeUeUeUeUeUeUeUeU
eUeUeUeUeUeUeUeUeUeUeUeU
eUeUeUeUeUeUeUeUeUeUeUeU
eUeUeUwUeUeUeUeUeUeUeUeU
eUeUeUsUeUeUeUeUeUeUeUeU
eUeUeUeUeUeUeUeUeUeUeUeU
eUeUeUeUeUeUeUeUeUeUeUeU
eUeUeUeUeUeUeUeUeUeUeUeU
eUeUeUeUeUeUeUeUeUeUeUeU

!

> Guide
< one way only
& arrow
@ aRaU
eUeUeUeUeUeUeUeUeUeUeUeU
eUeUeUeUeUeUeUeUeUeUeUeU
eUeUeUeUeUeUeUeUeUeUeUeU
eUeUeUeUeUeUeUeUeUeUeUeU
eUeUeUeUeUwUsUeUeUeUeUeU
eUeUeUeUeUeUeUeUeUeUeUeU
eUeUeUeUeUeUeUeUeUeUeUeU
eUeUeUlUeUeUeUeUeUeUeUeU
eUeUeUeUeUeUeUeUeUeUeUeU
eUeUeUeUeUeUeUeUeUeUeUeU
eUeUeUeUeUeUeUeUeUeUeUeU
eUeUeUeUeUeUeUeUeUeUeUeU

!

> Cyclotron
< needs bouncing
& bicycle
@ cL
eUeUeUeUeUeUeUeUeUeUeUeU
eUeUeUeUeUeUeUeUeUeUeUeU
eUeUeUeUeUeUeUeUeUeUeUeU
eUeUeUeUwUeUeUeUeUeUeUeU
eUeUeUeUeUeUeUeUeUeUeUeU
eUeUwUeUeUeUsUeUeUeUeUeU
eUeUeUeUeUeUeUeUeUeUeUeU
eUeUeUeUeUeUeUeUeUeUeUeU
eUeUeUeUlUeUeUeUeUeUeUeU
eUeUeUeUeUeUeUeUeUeUeUeU
eUeUeUeUeUeUeUeUeUeUeUeU
eUeUeUeUeUeUeUeUeUeUeUeU

!

> Energise!
< You'll need backup
& electric
@ dRpUaR
eUeUeUeUeUeUeUeUeUeUeUeU
eUeUeUeUeUeUeUeUeUeUeUeU
eUeUeUeUeUeUeUeUeUeUeUeU
eUeUeUeUeUeUeUeUeUeUeUeU
eUeUeUeUeUeUeUeUeUxUlLeU
eUeUeUeUeUeUeUeUeUeUeUeU
eUeUeUeUeUeUeUeUeUeUeUeU
eUeUeUeUeUeUsUeUeUeUeUeU
eUeUeUeUeUeUeUeUeUeUeUeU
eUeUeUeUeUeUeUeUeUeUeUeU
eUeUeUeUeUeUeUeUeUeUeUeU
eUeUeUeUeUeUeUeUeUeUeUeU

!

> Enuf of handholding
< Time for action
& eggshell
@ pRdDaL
eUeUeUeUeUeUeUeUeUeUeUeU
eUlDeUeUeUeUeUeUeUeUeUeU
eUeUeUeUeUeUeUeUeUeUeUeU
eUeUeUsUeUeUeUeUeUeUeUeU
eUwUeUeUeUeUeUeUeUeUeUeU
eUsUeUeUeUeUeUeUeUeUeUeU
eUeUeUeUeUeUeUeUeUeUeUeU
eUeUeUeUeUeUeUeUeUeUeUeU
eUeUeUeUeUeUeUeUeUeUeUeU
eUeUeUeUeUeUeUeUeUeUeUeU
eUeUeUeUeUeUeUeUeUeUeUeU
eUeUeUeUeUeUeUeUeUeUeUeU

!

> Over the precipe
< Breakthrough
& mortar
@ dUdL
eUeUeUeUeUeUeUeUeUeUeUeU
eUeUeUeUeUeUeUeUeUeUeUeU
eUeUeUeUeUeUeUeUeUeUeUeU
eUeUeUlReUeUeUaDeUeUeUeU
eUeUeUwUwUwUwUeUeUeUeUeU
eUeUeUeUeUeUwUeUeUeUeUeU
eUeUeUeUwUsUwUeUeUeUeUeU
eUeUeUeUwUeUeUeUeUeUeUeU
eUeUeUeUwUwUwUsUeUeUeUeU
eUeUeUeUeUxUeUeUeUeUeUeU
eUeUeUeUeUeUeUeUeUeUeUeU
eUeUeUeUeUeUeUeUeUeUeUeU

!

> Ring
< Energy is vital
& sauron
@ xUdDxU
eUeUeUeUeUeUeUeUeUeUeUeU
eUeUeUeUeUeUsUeUeUeUeUeU
eUeUeUeUeUeUeUeUeUeUeUeU
eUeUeUeUeUwUwUeUeUeUeUeU
eUeUlReUwUeUeUwUeUeUeUeU
eUeUeUwUeUsUeUeUwUeUeUeU
eUeUeUwUeUeUsUeUwUeUeUeU
eUeUeUeUwUeUeUwUeUeUeUeU
eUeUeUeUeUaRaUeUeUeUeUeU
eUeUeUeUeUeUeUeUeUeUeUeU
eUeUeUeUeUeUeUeUeUeUeUeU
eUeUeUeUeUeUeUeUeUeUeUeU

!
